**********
*P       *
*        *
*        *
*        *
*        *
*        *
*       M*
*       G*
**********