**********
*P       *
*   M    *
*        *
*      M *
*  M     *
*        *
*       M*
*  M    G*
**********